
                                                                 
                                                                                o       -
                                                                               o o      *
                     o 1 o    o 2 o                                           o o o     *
             1      GGGGGGG  GGGGGGG       oooo         1                    o o o o    *
            GG                         2   GGGG        GGG        2   2   2             *
                      2     2     2          2        2        2            2GG         *
                 GG                   GG                       GG           GGG         *
 P      GG  1    GG     1      1      GG    1   1      1   1   GG   1  1   GGGG  1  1   =
GGGGGGGGGGGGGGGGGGGGGGGGGGGGGGGGGGGGGGGGGGGGGGGGGGGGGGGGGGGGGGGGGGGGGGGGGGGGGGGGGGGGGGGGGG